
aback : adv orqaga :  orqadan; orqasi bilan; be taken ~ hayratda qoldiradigan, hayratomuz
abacus : n [C] (pl~es or, -ci ) cho`t
abandon : vt 1) tashlab ketmoq; 2) rad etmoq
abase (to, before) : vt xo`rlamoq, kamsitmoq
abasement : n [U] xo`rlash, kamsitish, yerga urish; kamsitilish, xo`rlanish
abashed : uyatchan, tortinchoq, xijolatli
abashment : n [U] 1) xijolat bo`lish; 2) sarosima, sarosimalik
abate : vt, vi ozaytirmoq, kamaytirmoq, pasaytirmoq, sekinlatmoq
abbess : n [C] bosh rohiba (katolik ayollar monastirining boshlig`i)
abbey : n [C] (pl~s) abbatlik (katoliklar monastiri va unga qarashli joy-mulk)
abbot : n [C] bosh rohib (katolik erkaklar monastirining boshlig`i)
abbreviate : vt qisqartirmoq
abbreviation : n [C] qisqartma
abdicate (from) : vt, vi 1) inkor qilmoq; 2) voz kechmoq, bahridan o`tmoq
abdomen : n [C] qorin.
abduct : vt kuch ishlatib olib ketmoq, o`g`irlamoq (bola yoki odam o`g`irlamoq)
aberration : n [U] fikrda yanglishish, adashish, haqiqatdan chetga chiqish
abet (in) : vt (-tt-) yomon ishga undamoq, gijgijlamoq
abeyance : n [U] bedaraklik, noaniqlik (vaqtincha)
abhor : vt (-rr) jirkanmoq, nafratlanmoq
abhorrent : adj jirkanch, xunuk, nafratni qo`zg`atuvchi
abide : vt, vi 1) sodiq qolmoq; 2) chidamoq, sabr qilmoq
abiding : doiymiy; uzluksiz, to`xtovsiz
ability : n (pl-ies) [C] qobiliyat, iqtidor
abject : ayanchli, achinarli
abjuration : n [U] voz kechish, yuz o`girish
abjure : vi voz kechmoq; yuz o`girmoq
ablaze (with) : , adv olovda, alanga ichida
able : adj 1) mohir, omilkor; 2) qobiliyatli, iqtidorli
able-bodied : 1) chidamli, sog`lom; 2) yaroqli (harbiy xizmatga oid)
ablution(s) : n yuvinish, tahorat qilish; tahorat
ably : adv mohirona
abnegation : n inkor etish; voz kechish
abnormal : g`ayri-tabiiy, nojo`ya g`alati
aboard : adv, prep kema bortida, poyezdda, samolyotda :  all ~! Samolyot, poezd yoki kemaga chiqish (transport vositasiga) tugallanyapti!
abode : n [U] turar-joy, uy-joy, makon
abolish : vt bekor qilmoq; tugatmoq
A-bomb : n [C] atom bombasi
abominable : 1) jirkantiradigan, jirkanch; 2) yaramas, juda yomon
aboriginal : n [C] tub joyli, azalgi, oldingi
aborigine(s) : n [C] mahalliy kishi, tub joyli kishi, aborigen (Avstraliyalik)
abort : vt bola oldirmoq
abortion : n [C] abort (bola oldirish)
abortive : adj vaqtidan ilgari tug`ilgan
abound : vi mo`l bo`lmoq (in); to`lib toshmoq (with)
about 1 : adv 1) taxminan, atrofida, deyarli :  You are ~ right Siz deyarli haqsiz It us ~ five o`clook Hozir soat taxminan besh bo`ldi; 2) yaqin, uzoq emas :  He is somewhere ~ U shu yaqin atrofda bo`ladi; 3) hamma yerda, har joyda; teverak-atrofga; atrofda :  to look
about 2 : prep 1) haqida, to`g`risida :  What do you know ~ him? U haqida nima bilasiz? Tell me all ~ it U to`g`risidagi hamma narsani menga aytib bering; 2) yaqinida, yonida :  ~ nightfall kechga yaqin; 3) yaqinida, yonida, oldida (joylashish o`rnini bildiradi) :  the
above 1 : adv 1) yuqorida, tepada; yuqori, katta :  Children ~ twelve are allowed O`n ikki yoshdan katta (yuqori) bolalarga ruxsat etiladi; 2) tepaga, yuqoriga; a staircase leading ~ yuqoriga olib chiqadigan zina; 3) ilgari, burun; as stated ~ ilgari ta`kidlab o`til
above 2 : prep 1) ustida, tepasida (o`rni yoki turgan joyini aniqlab keladi) :  ~ my head boshimning tepasida; 2) ko`p, oshiq, ziyod, ortiq :  ~ measure me`yoridan ortiq 3) tashqari, xoli :  ~ suspicion shubhadan holi
abrasive 1 : dag`al, qo`pol
abrasive 2 : n [U] qumqog`oz, abraziv
abreast : adv yonma-yon, yelkama-yelka, bir safda
abridge : vt 1) qisqartirmoq; 2) chegaralamoq
abroad : adv chet mamlakatda, chet mamlakatga, tashqarida
abrogate : vt bekor qilmoq, kuchdan qoldirmoq
abrupt : kutilmaganda, birdan, to`satdan; keskin; tez
abscess : n [C] chipqon; yiring
absence (from, of) : n [U] 1) ishtirok etmaslik, qatnashmaslik; 2) yo`q bo`lish, mavjud bo`lmaslik, yo`qlik
absent (from) : adj hozir bo`lmagan, kelmagan
absent-minded : parishon, parishonxotir
absolute : 1) batamom, tamomila, so`zsiz; 2) mutlaq, chegaralanmagan, cheksiz
absolutely : adv 1) tamoman, tamomila, mutlaqo, butunlay; 2) to`la-to`kis, albatta
absolution : n [U] 1) avf etish; 2) gunohidan o`tish
absolve : vt 1) kechirmoq; gunohidan o`tmoq; 2) bo`shatmoq, ozod qilmoq (vazifasidan)
absorb : vt 1) so`rmoq, shimmoq; 2) g`arq bo`lmoq
absorption : n [U] so`rish, shimish
abstain (from) : vi 1) o`zini tiymoq, o`zini tutmoq; 2) ovoz berishda betaraf bo`lmoq
abstinence (from) : n [U] o`zini (nafsini) tiyish; saqlanish
abstract 1 : mavhum
abstract 2 : n [C] parcha, qisqa mazmun
absurd : adj bema`ni, behuda, mantiqsiz
abundance (of) : n [U] mo`lchilik, serobgarchilik, to`lib-toshish
abundant : serob; mo`l
abuse 1 : vt suiiste`mol qilmoq; so`kmoq; haqorat qilmoq; qarg`amoq
abuse 2 : n [U,C] 1) suiiste`mol qilish; 2) haqorat, tahqir, so`kish
abusive : haqoratli, tahqirli
abyss : n [C] (pl~es) tubsiz jarlik
acacia : n [C] akatsiya (oq yoki sariq gulli dukkakli daraxt)
academic : akademik (o`qish-o`qitish jarayoniga oid)
academy : n [C] (pl~ies) akademiya (ayrim ilmiy muassasalar nomi)
accede(to) : vi qabul qilmoq, rozi bo`lmoq, ma`qullamoq
accelerate : vt, vi tezlashtirmoq, oshirmoq, kuchaytirmoq
accelerator : n [C] tezlatkich; tepki (biror jarayonni tezlashtiruvchi mexanizm yoki modda)
accent : n [C,U] 1) urg`u; 2) sheva talaffuzi; aksent
accentuate : vt 1) urg`u bermoq; 2) ta`kidlamoq; 3) urg`u qo`ymoq
accept : vt, vi 1) qabul qilmoq; 2) rozi bo`lmoq, ko`nmoq, ma`qullamoq
acceptable : ma`qul
access 1 (to) : n [U] kirish yo`li (kirish huquqi, foydalanish huquqi)
access 2 : vt ma`lumot (axborot) olmoq yoki joylashtirmoq (kompyuter tizimi bo`yicha)
accessible : kirish (borish, o`tish) mumkin bo`lgan, yo`lab (borib, chiqib) bo`ladigan
accessory : n [C] (pl-ies) 1) jihoz, asbob; 2) yoqlovchi, xayrixoh, tarafdor
accident : n [C] tasodif; baxtsiz voqea
accidental : tasodifiy, kutilmagan
accidentally : tasodifan, to`satdan
acclaim (as) : vt olqish bilan kutib olmoq, olqishlamoq
acclimatize (to) : vt, vi yangi iqlimga, sharoitga o`rganmoq, ko`nikmoq, moslashmoq
accommodate : vt 1) moslashmoq; 2) boshpana bermoq; 3) ta`minlanmoq
accommodation : n [U] 1) moslashish; 2) qulaylik; yordam; 3) boshpana, qarorgoh
accompany : vt (pt, pp-ied) birga bormoq, yo`ldosh bo`lmoq
accomplice : n [C] hamroh, sherik
accomplish : vt bitirmoq, muvaffaqiyatli tugatmoq
accomplished (at) : muvaffaqiyatli tugallangan, yakunlangan
accord 1 : (with) vt, vi rozi bo`lmoq, qabul qilmoq; moslashmoq
accord 2 : (with) n [U, C] 1) rozilik, sulh; 2) of one`s own ~ o`z xohishi bilan, ixtiyoriy ravishda
according : prep muvofiq ravishda, yarasha, munosib; ...ga ko`ra
account 1 : n [C] 1) hisob, sanoq; kirim/chiqim qaydi (...bankdagi hisob); 2) hisobot; tafsilot; 3) ahamiyat; ? on ~ of shu sababli; on no ~ nima bo`lganda ham; take into ~ nazarga olmoq, hisobga olmoq, e`tiborga olmoq
account 2 : (for) vt,vi 1) hisoblamoq; 2) hisobot bermoq
accountant (of) : n [C] 1) hisobchi; buxgalter-ekspert; 2) aybdor, javobgar
accredit : vt 1) vakolat bermoq; 2) vakil qilib tayinlamoq
accumulate : vt, vi jamg`armoq, to`plamoq, orttirmoq
accumulator : n [C] akkumulyator
accuracy : n [U] 1) aniqlik, to`g`rilik; 2) puxtalik; ~ of fire merganlik, bexatolik
accurate : to`gri, aniq, puxta
accusation : n [C,U] 1) ayblash; qoralash; 2) ayblash akti
accuse (of) : vt ayblamoq, qoralamoq
accustom (to) : vt o`rgatib qo`ymoq, odatlantirmoq, o`rgatmoq
ace (of) : n [C] 1) ochko (yutuq hisobi); 2) o`z ishining ustasi, mohir kishi, ustasi farang
ache 1 : vi 1) og`rimoq; kasal (betob) bo`lmoq; 2) chanqamoq, tashna bo`lmoq; orzumand bo`lmoq
ache 2 : n [C, U] og`riq, dard
achieve : vt 1) erishmoq, yetishmoq; 2) oxiriga yetmoq, maqsadga yetmoq
acid 1 : nordon
acid 2 : n [C,U] ishqor, kislota
acknowledge (as) : vt 1) e`tirof etmoq, tan olmoq; 2) tasdiqlamoq, qabul qilmoq
acme (of) : n [C] yuqori nuqta, yuksaklik, mukammallik
acne : n [U] husnbuzar
acoustic : akustikaga oid, akustik
acquaint (with) : vt 1) tanishtirmoq, bildirmoq; 2) ma`lumot bermoq, xabar bermoq
acquaintance (with) : n [U,C] 1) tanishuv, tanishishlik; 2) tanish, og`ayni
acquire : vt qozonmoq; ega bo`lmoq; erishmoq
acquisition (of) : n [C,U] 1) egallash, erishish; 2) yutuq, muvaffaqiyat
acquit (of) : vt (-tt-) oqlamoq, ayblovni bekor qilmoq
acre : n [C] akr (4050 metr joy =0,4ga), yer o`lchami
acrid : o`tkir, keskin, achchiq
acrobat : n [C] akrobat
across 1 : adv 1) narigi tomonda, narigi tomonda; 2) ko`ndalang, eniga
across 2 : prep 1) orqali, orqasidan, ichidan :  to run ~ the street ko`chani kesib o`tmoq; 2) ko`ndalang :  a tree laid ~ the road daraxt yo`lda ko`ndalang bo`lib yotardi
act 1 : (as, on, for) vi, vt 1) harakat qilmoq, bajarmoq; 2) rol ijro etmoq
act 2 : n [C] 1) ish, harakat, akt; 2) parda, ko`rinish; 3) qonun
action : n [U,C] 1) harakat, ish; faoliyat, fe`l; 2) samara, ta`sir
activate : vt harakatga keltirmoq, harakat qilmoq; qimirlamoq, siljimoq
active : serharakat, faol, ishchan, g`ayratli
activity : n [U,C] (pl-ies) harakat, mashq, faoliyat
actor : n [C] teatr yoki kino aktyori, artist
actress : n [C] aktrisa (ayol)
actual : haqiqiy; asosiy, muhim
actually : adv haqiqatda, chindan, aslida
acupuncture : n [U] igna bilan davolash, akupunktur
acute : 1) o`tkir; kuchli; 2) keskin; ziyrak; 3) 90Â° dan kichik burchak
AD : abbr milloddan keyin
ad : n abbr e`lon, reklama
adage : n [C] maqol, matal, hikmatli so`z
adamant : sabotli, matonatli, qaytmas, qat`iy, bukilmas
adapt : vt moslamoq, muvofiqlamoq, moslashtirmoq
adaptation : n [U] moslashtirish, moslash
adapter, adaptor : n [C] 1) badiiy asarni moslashtiruvchi; 2) adaptyer, tovush olgich
add (to) : vt, vi 1) qo`shmoq, birlashtirmoq; 2) sonlarni qo`shmoq; 3) qo`shimcha (gap) aytmoq, qo`shimcha qilmoq
adder : n [C] zaharli qora ilon.
addict : n [C] nashavand, ichishga yoki chekishga ruju qo`ygan kishi
addition : n [U] 1) qo`shuv, qo`shish; 2 in ~ (to) qo`shimcha ravishda
additional : qo`shimcha, ilova
addle(d) : 1) aynigan, palag`da; 2) chalkash, dovdir.
address 1 : vt murojaat qilmoq, nutq so`zlamoq
address 2 : n [C] 1) adres, manzilgoh; 2) murojaat, nutq
addressee : n [C] adresat, oluvchi
adept : bilimdon, ekspert
adequate : mos, muvofiq, munosib, loyiq, to`g`ri keladigan, javob beradigan
adhere : vi 1) yopishmoq; 2) sodiq bo`lmoq, qo`shilmoq
adherent : n [C] ergashuvchi, tarafdor
adhesive : n [C,U] yelim, yopishqoqlik
adjacent : tutashtiruvchi, yonma-yon
adjective : n (gram.) sifat
adjoin : vt, vi yondosh bo`lmoq, yopishib turmoq, tutashib turmoq
adjourn : vt, vi keyinga surmoq, keyinga qoldirmoq, kechiktirmoq
adjournment : n [C,U] keyinga qoldirish, keyinga surish
adjudicate : vt, vi 1) hakamlik qilmoq; 2) sud qilmoq
adjust : vt tuzatmoq, yaroqli holga keltirmoq; tartibga solmoq; moslashmoq
admeasure : vt o`lchab chiqmoq, chegarasini aniqlamoq
administer : vt 1) boshqarmoq, idora qilmoq; 2) dori bermoq
administration : n [U] ma`muriyat, idora, boshqarma
admirable : g`oyat go`zal, jozibali, ajoyib, o`ziga tortadigan, hayratlanarli
admiral : n [C] admiral (harbiy dengiz floti oliy qo`mondonlik unvoni)
admiration : n [U] quvonch, zavq
admire : vt zavqlanmoq, hayron qolmoq, qoyil qolmoq, shodlanmoq, maftun bo`lmoq
admissible : maqbul, ma`qul, muvofiq, qabul qilsa bo`ladigan
admission : n [U,C] 1) e`tirof etish; 2) yo`l qo`yish, ruxsat
admit : vt 1) yo`l qoymoq, ruxsat etmoq; 2) inobatga olmoq, rozi bo`lmoq
admonish : vt 1) ogohlantirmoq, ogohlantirib qo`ymoq; 2) ko`ndirishga harakat qilmoq
ado : n [U] behuda ish, ovoragarchilik, besaranjomlik, tashvish, g`avg`o
adolescent : n, adj [C] yosh; o`smir; voyaga yetgan, balog`atga yetgan
adopt : vt, vi 1) boqib olmoq, (bola) asrab olmoq; 2) o`zlashtirmoq; 3) qabul qilmoq (qaror qabul qilmoq)
adorable : sevimli, yoqimtoy.
adore : vt qattiq sevmoq
adorn : vt bezatmoq, chiroy qo`shmoq
adrift : adv, adj oqim bilan ko`chib yurish
adult : n [C] voyaga yetgan (kishi)
adulterate : vt (pl-ies) [U] soxtalashtirmoq, qalbakilashtirmoq
adultery : n zino, xiyonat
advance 1 : vi, vt 1) oldinga yurmoq, siljimoq, ilgarilamoq; 2) taqdim etmoq, fikrini bildirmoq
advance 2 : n [C,U] 1) rivojlanish, taraqqiyot; 2) avans (pul) :  3) in ~ oldindan, ilgaridan.
advanced : ilg`or, intiluvchan, o`zlashtiruvchi.
advantage (over) : n [C] 1) afzallik, ustunlik, ortiqlik, imtiyoz; 2) take ~ of foydalanish (imkoniyatdan foydalanish)
advent (of) : n [U] 1) din. kelish; voqey bolish, paydo bolish; 2) roza (xristianlarda; go`sht, sutli, tuxumli mahsulotlarni yeyish man qilinadigan kunlar); 3) qavm (biror butxonaga qatnovchi dindorlar)
adventure : n [C, U] sarguzasht
adverb : n [C] (gram) ravish
adversary : [C] (pl-ies) n raqib, dushman; g`anim
adverse : 1) dushmanlik bilan; 2) zararli, ziyon keltiradigan; yomon
advertise : vt, vi ma`lum qilmoq, e`lon qilmoq, reklama qilmoq
advertisement : n [C] e`lon, reklama
advice : n [U] 1) maslahat; 2) bildirish, xabarnoma
advisable : mulohazali, o`ylab ish qiladigan
advise : vt, vi maslahat bermoq
adviser : n [C] maslahatchi; maslahat beruvchi
advocate : n [C] advokat, oqlovchi, himoyachi
adze : n [C] tesha (novtesha)
aerial : n antenna
aerodrome : n [C] aerodrome (samolyot qo`nadigan maydon)
aeroplane : n [C] aeroplan, samalyot
aesthetic : adj nafis, go`zal, nafosatli, didli
affair : n [C] ish, yumush
affect : vt ta`sir qilmoq
affectation : n [U] mug`ombirlik, soxtalik, yasamalik
affection : n [C, U] sevgi, muhabbat, mehr, mayl
affectionate : mehribon, samimiy
affiliate (-with, to) : vt 1) a`zolikka qabul qilmoq; 2) birlashtirmoq, bog`lamoq
affinity : n [C] (pl-ies) yaqinlik, o`xshashlik
affirm : vt, vi 1) tasdiqlamoq, ta`kidlamoq; 2) isbot qilmoq
affirmative : adj tasdiqlaydigan, ma`qullaydigan, ijobiy, bo`lishli
affix 1 : vt bog`lamoq, biriktirmoq; ilova qilmoq
affix 2 : n [C] gram. qo`shimcha, affiks
afflict (with) : vt ozor yetkazmoq, ranjitmoq, ozor bermoq
affliction : n [C, U] 1) ranjish; 2) baxtsizlik, qayg`u
affluent : boy; mo`l-ko`l, serob (daryo haqida)
afford : vt qurbi yetmoq
affront : n [C] haqorat, tahqir
afloat : ,adv suvda, dengizda (muallaq)
afraid (of, for) : qo`rqqan, cho`chigan
afresh : adv 1) yangidan, qaytadan
after : prep, conj. 1) ...dan keyin, ...dan so`ng :  only ~ you! ~ lunch; ~ work; faqat sizdan so`ng!, tushlikdan so`ng; ishdan keyin; 2) keyin, so`ng, so`ngra :  ~ 10 years 10 yildan keyin; ~ his departure jonae ketganidan keyin; 3) ~ all qaramasdan, bari bir, nima
aftermath : n [U] oqibat, natija
afternoon : n [C, U] peshin, tushdan keyin
after-shave (lotion) : n [C, U] soch va soqol olingandan keyin suriladigan lasyon, krem
aftershock : n [U] geol. yer silkinishidan keyingi silkinish, yer silkinishining qaytishi
afterwards : adv keyinchalik, oqibatida, natijada
again : adv yana, takroran, qaytadan
against : prep 1) qarshi, qarshi tomonga :  We sailed ~ the wind Biz shamolga qarshi suzdik; They were ~ this proposal Ular bu taklifga qarshi bo`ldilar; 2) qarshi tomonga, ... dan, ... ga :  She leaned ~ the fence U qarshisidagi devorga suyanib turar edi; 3) biror na
age : n [C,U] 1) yosh; 2) asr; davr
aged 1 : adj yoshdagi, yoshida
aged 2 : adj qari, juda keksa, yoshi ulg`aygan
ageless : adj eskirmaydigan; umrboqiy, o`zgarmaydigan
agency : n agentlik, organ, vakolatxona, mahkama
agenda : n [C] kun tartibidagi masalalar, navbatda(gi), galda(gi)
agent : n [C] 1) arbob; 2) vakil; 3) ayg`oqchi
aggrandize : vt 1 ko`paytirmoq; oshirmoq; 2) ulug`lamoq, ko`klarga ko`tarmoq; 3) yuqori lavozimga ko`tarmoq, martabasini oshirmoq
aggravate : vt yomonlashtirmoq, battar qilmoq, og`irlashtirmoq
aggregate 1 : vt, vi 1) birlashtirmoq; 2) to`planmoq, yig`ilmoq
aggregate 2 : n [C] hammasi, barchasi, jami, majmui, to`plam
aggression : n [U] hujum, bosqinchilik, tajovuz
aggressive : adj bosqinchi, tajovuzkor, hujum qiluvchi
aghast (at) : adj dovdirab qolgan; qo`rquvdan qotib qolgan
agile : adj tez, chaqqon, epchil, uddaburon
agitate : vt, vi 1 tashviqot yurgizmoq; 2) silkitmoq, chayqa(t)moq, titratmoq
agitation : n [U] tashviqot
agitator : n [C] tashviqotchi
ago : adv avval, oldin, ilgari, burun, muqaddam
agonize : vi qiynalmoq, iztirob chekmoq
agony : n [C, U] iztirob, qiynoq, dard, jon talvasasi
agrarian : adj agrar
agree (with, on) : vi, vt qabul qilmoq, rozi bo`lmoq, ko`nmoq
agreeable : adj yoqimli, ko`ngilli, mos keladigan
agreement : n [C, U] 1 kelishuv, bitim, rozilik; 2) shartnoma, ahdnoma, ahd
agriculture : n [U] qishloq xo`jaligi; dehqonchilik
aground : adv, adj botib qolgan, qumga tiqilib qolgan; qiyinchilikda qolgan
ahead : adj, adv olg`a, oldinga; oldida, oldindan
aid 1 (with, in) : vt yordam bermoq, ko`maklashmoq
aid 2 : n [U] yordam
AIDS, Aids : n OITS kasalligi
ail : vt, vi kasal bo`lmoq, xastalanmoq; tashvishlantirmoq, bezovta qilmoq, og`ritmoq, azob bermoq
aim 1 (at, for) : t, vi maqsad qilib qo`ymoq, maqsadga erishmoq, niyatga yetmoq
aim 2 : n [U, C] 1) maqsad, niyat; 2) mo`ljal
air 1 : /n [U] 1) havo; 2) yuz (ifodasi); vajohat
air 2 : vt 1) quritmoq; 2) havo almashtirmoq, shamollatmoq
airbag : n [C] havo to`ldirilgan yostiq (mashinada)
air-base : n [C] aviabaza
airborne : adj havoda olib o`tiladigan
airbus : n [C] mahalliy yo`nalishdagi samolyot
air conditioning : n [C] konditsioner
aircraft : n [C] aeroplan, kichik samolyot
air crew : n [C] samolyot ekipaji
airfield : n [C] samolyot uchadigan va qo`nadigan joy, aerodrom
Air Force : n [C] harbiy havo kuchlari
air hostess : n [C] styuardessa
airline : n [C] havo yo`li
air mail : n [U] havo pochtasi
airport : n [C] tayyoragoh, aeroport
air-raid : n [C] bombardimon qilish, havo hujumi
airsick : havo kasalligi
air-tight : germetik, havo o`tkazmaydigan
airway : n [C] havo yo`li
airy : adj 1) bahavo; havosi yaxshi; 2) xushchaqchaq; yengiltak
aisle : n [C] koridor, yo`lak
ajar : adj bir oz ochiq, qiya
alarm : n [U, C] 1) taxlika, vahima belgisi; 2) signal, trevoga; 3) vahima, qorqinch
alarm-clock : n [C] soat, qo`ng`iroqli soat
alas : int. afsus, evoh, voy
albatross : n [C] albatros (tumshug`i uzun katta dengiz qushi)
albino : n [C] (pl~s) albinos, oq
album : n [C] 1) albom; 2) mashhur kishilar dastxatlari yozilgan kitob; 3) rasm daftari
alchemy : n [U] alkimyo; mo`jiza
alcohol : n [U] alkogol, spirtli ichimlik
ale : n [C,U] kuchli pivo
alert : adj ogoh, tetik, sezgir, hushyor
algebra : n [U] algebra
alibi : n [C] (pl~s) alibi, isbot, guvohlarga ega bo`lish, jinoyat joyida bo`lmaganlikni ko`rsatish
alien : n [C] chet ellik, begona, g`alati
alight : adj yonayotgan; o`t orasida; chaqnoq; yorug`, yoritilgan
alike : adj o`xshash
alimentary : ovqatni hazm qiladigan
alimony : n [U] nafaqa (aliment)
alive : adv yashayotgan, tirik
all 1 : adj to`la qonli, butun, tamomila, tamoman
all 2 : pron. hamma, har narsa; barcha
Allah : n Alloh
allegation : n [U,C] bayonat, da`vo
allege : vt 1) dalil qilib ko`rsatmoq; 2) asossiz ta`kidlamoq
allegiance : n [U, C] sadoqat, vafodorlik, sodiqlik
allergy (to) : n [C] allergiya
alleviate : vt yumshatmoq; (og`riqni)kamaytirmoq
alley : n [C] (pl~s) tor ko`cha
alliance : n [C] ittifoq, birlashma
allied : ittifoqdosh
alligator : n [C] aligator, Amerika timsohi
allocate : vt 1) taqsimlamoq, joylashtirmoq; 2) ulushini bermoq
allot (to) : vt (tt) ajratmoq, taqsimlamoq
allow : vt, vi 1) ruxsat bermoq, yo`l qo`ymoq, ijozat bermoq; 2) imkon bermoq, izn bermoq
allowance : n [C] oylik maosh; stipendiya; nafaqa; ta`minot
alloy : n [U] eritma, quyma
all right : adj, adv 1) yaxshi, hammasi joyida; 2) talablarga javob beradigan, qabul qilinadigan; 3) rozilik; All right! Roziman! Bo`pti! Xo`p!
allude (to) : vi 1) ishora qilmoq, sezdirmoq; 2) nazarda tutmoq; ko`zda tutmoq
allure : vt, vi tuzoqqa tushirmoq; o`ziga tortmoq; aldab qo`lga olmoq
allusion : n [C, U] imoâ ishora, luqma, kinoya
ally : n [C] (pl~ies) ittifoqdosh, sherik
almanac : n [C] taqvim
almighty : qudratli, kuchli, qodir
almond : n [C] bodom
almost : adv deyarli, qariyb, salkam
alms : n [U] sadaqa, ehson, zakot
alone : , adv yolg`iz
along 1 : adv 1) oldinga; 2) o`zi bilan (birga)
along 2 : prep bo`ylab :  ~ the river daryo bo`ylab
alongside : adv yonma-yon, yaqinida
aloof (from) : adj, adv o`zini chetga oluvchi, aralashmaydigan, loqayd
aloud : adv baland, yuqori (ovozda)
alphabet : n [C] alifbo
already : adv 1) allaqachon; 2) kutilgandan ham tez
also : adv yana, ham
alter : vt, vi o`zgar(tir)moq
alteration (of) : n [C, U] o`zgar(tir)ish
alternate 1 (with, between) : vt, vi almashinmoq, bir-birini o`rniga turmoq
alternate 2 : adj galma-gal, navbat bilan
alternative 1 : adj tanlashga oid
alternative 2 : (to) n [C] alternativ, tanlov
although : conj garchi, ...bo`lsa ham
altitude : n [C] (pl) (dengiz sathidan) baland, balandlik
altogether : adv batamom, butunlay
aluminium : n [U] alyuminiy (metal)
always : adv doim, har doim, har vaqt
am : v to be fe`lining aniqlik mayli, hozirgi zamon birinchi shaxs, birlik shakli
a.m. : abbr. ertalab
amalgam : n [C] simob qorishmasi (simobning biror metal bilan qorishmasi)
amalgamate : vt, vi aralashtirmoq, qorishtirmoq
amass : vt yig`moq, to`plamoq
amateur : n [C] havaskor
amaze : vt taajublantirmoq, hayron qoldirmoq
ambassador : n [C] elchi, diplomat
amber : n [U] qahrabo
ambience : n [C] 1) atrof; atrof-muhit; atmosfera; 2) atrofdagi kishilar, yaqinlar; doira; muhit
ambiguity : n (pl-ies) [U, C] ikki ma`nolilik, dudmallik
ambition : n [U] 1) shuhratparastlik, izzattalab, izzat-nafs; [C] 2) intilish, maqsad, xohish
ambitious : shuhratparast, izzaltalab
ambulance : n [C] tez yordam
ambush : vt, vi pistirma qo`ymoq, pistirmadan hujum qilmoq
ameliorate : vt, vi yaxshilamoq, tuzatmoq
amen : int omin (fotiha); to say ~ to smth fotiha o`qimoq
amend : vt ishlov bermoq, tuzatmoq, sozlamoq
amendment : n [C, U] tuzatish, o`nglash, sozlash
amiable : do`stona, samimiy
amicable : do`stona, o`rtoqlarcha
amid (amidst) : prep orasida, o`rtasida
amiss : , adv noto`g`ri, yanglish, xato
ammonia : n [U] ammiak
ammunition : n [U] o`q-dori
ammo : n [U] ammunition ga qarang
amnesia : n [U] esini, xotirasini yo`qotish
amnesty : n [C] (pl-ies) kechirim, avf
among(st) : prep 1) orasida, o`rtasida :  I was born in the village ~ the hills men tog`lar orasida qishloqda tug`ilganman; 2) qatorida, orasida :  We consider you ~ our coleagues biz sizni hamkasbimiz (qatorida) deb bilamiz; 3) ... dan biri :  one of ~ thousand mingdan
amorous : 10 sevuvchan, tez oshiq bo`ladigan; 2) sevib qolgan, oshiqona
amount : [C] jami, yig`indi, miqdor
amp(ere) : n [C] amper (tok kuchining o`lchov birligi)
amphibian : n [C] ham suvda, ham quruqlikda yashovchi hayvon
amphitheatre : n [C] amfiteatr
ample : adj (-r,-st] yetarli, mo`l-ko`l
amplifier : n [C] ovozni kuchaytiruvchi moslama, amplifikator
amplify (on) : vt (pt, pp,-ied) 1) kengaytirmoq; 2) fikrni rivojlantirmoq; 3) kuchaytirmoq
amputate : vt (badanni) kesmoq, kesib olib tashlamoq
amulet : n [C] tumor
amuse : vt 1) kuldirmoq; 2) vaqtni chog` o`tkazmoq; ko`ngilni ochmoq
amusing : zavqli, kulgili
an : indef. bir, bitta (unli tovush bilan boshlangan sifatlovchi ot oldida)
anachronism : n [C] anoxronizm (yil hisobi yoki tarixiy sanani ko`rsatishda xronologiyadagi xatolik); xatolik-yanglishish
anaemia : n [U] kamqonlik, animiya
anaesthesia : n [U, C] anesteziya (og`riq sezish qobiliyatini yoqotish; behush qilish)
anagram : n [C] anagramma, bir so`z tarkibidagi harflarning joylashishini o`zgartirib, boshqa so`z hosil qilish
anal : inson yoki hayvondagi orqa chiqarish yo`li, axlat chiqarish yo`li
analgesic : n [C] og`riqni bosadigan (dori-darmon haqida)
analogy : n [C] (pl-ies) o`xshashlik, o`xshatma
analyse : vt tahlil qilmoq
analysis : n [U, C] (pl-ies) tahlil
anarchy : n [U] 1) anarxiya bezorilik; 2) boshboshdoqlik, tartibsizlik, xo`jasizlik
anatomy : n [U, C] anatomiya (tirik organizmlarning tuzilishi haqidagi fan)
ancestor : n [C] ota-bobo, ajdod
anchor : n [C] langar
anchor man : n [C] (pl-men) diktor, boshlovchi
anchovy : n [C] (pl-ies) anchous, xamsa (mayda dengiz balig`i)
ancient : qadimgi
ancillary : yordamchi, tobe, qaram
and : cj va, ham; esa
anecdote : n [C] latifa; hikoya, anekdot
anew : adv 1) yana, takroran; boshqatdan; 2) yangidan
angel : n [U] farishta; malak
anger : n [U] jahl, g`azab, nafrat, qahr
angle : n [C] 1) burchak; 2) nuqtayi nazar, fikr
anglicize : vt inglizga aylantirmoq
angry : adj (ier,-iest) badjahl, jahli tez, darg`azab
anguish : n [U] dard, og`riq, iztirob
angular : burchakli, qirrali
animal : n [C] hayvon
animate : vt jonlantirmoq
animation : n [U] 1) jonlantirish, jonlanish; 2) jonli multfilm yaratish, animatsiya
animosity : n (pl-ies) [U,C] dushmanlik, xusumat
ankle : n [C] to`piq
anklet : n [C] oyoqqa taqiladigan taqinchoq
annex : vt 1) nazorat qilmoq; egallab olmoq, bosib olmoq; 2) to`ldirmoq; ilova qilmoq
annexation : n [U, C] bosib olish, zabt etish, bosqinchilik, egallash
annihilate : vt 1) yo`q qilmoq, butunlay buzib tashlamoq; 2) barham bermoq
anniversary (of) : n [C] (pl-ies) yubiley; yillik qutlov (yil to`lish marosimi, yillik bayram)
annotate : vt sharhlamoq; izohlamoq (qisqa mazmunini yozmoq)
announce : vt bildirmoq, e`lon qilmoq (tantanali ravishda)
announcement : n [C] e`lon, anons
announcer : n [C] so`zlovchi, boshlovchi, e`lon qiluvchi
annoy : vt 1) joniga tegmoq; jig`iga tegmoq, jahlini chiqarmoq; 2) alam o`tkazmoq, xo`rligini keltirmoq, o`ksitmoq, ranjitmoq
annual : adj yillik
annuity : n [C] (pl-ies) yillik renta, yillik pul ajratish
annul : vt yo`q qilmoq, qaytarmoq, bekor qilmoq
anode : n [C] anod (musbat elektrod)
anomalous : meyordan tashqari; aqli zaif; g`ayritabiiy, g`alati, kutilmagan, teskari
anonymous : anonim, nomsiz, ismsiz; anonim holda
anorak : n [C] bosh kiyimli kurtka, anorak
another : 1) yana, keyingi; 2) boshqa.
answer 1 : vt, vi javob bermoq
answer 2 : n [C] javob
ant : n [C] chumoli
antagonism (to) : n [U] qarshilik, ziddiyat, kelishtirib bo`lmaydigan qarama-qarshilik
Antarctic : n [C] Antarktika (Janubiy qutb)
antecedent : adj 1) avvalgi, oldingi, oldidagi; 2) n [C] o`tmish hayot; avlod-ajdod
antelope : n [C] antilopa, bug`u, ohu (juft tuyoqli kavsh qaytaruvchilarning katta bir guruhi)
antenna : adj [C] (pl~e) paypaslagich, qisqich (ba`zi hasharot va hayvonlarning mo`ylovsimon qo`llari)
anthem : n [C] gimn, madhiya
anthology : n [C] (pl~ies) antologiya; majmua, to`plam
anthrax : n [C] 1 karbunkul, ho`ppoz, ko`k yara; 2) kuydirgi
anti... : pref zid, qarshi
antibiotic : adj [C] antibiotik
antibody : n [C] (pl-ies) antikor, immunitet
anticipate : vt oldindan ko`rmoq, payqamoq; kelajakni ko`rmoq, uzoqni o`ylamoq
anticlockwise : adv soat millariga qarshi
antics : n [U] taltayish, erkalanish, tantiqlik; nayrangbozlik
anticyclone : n [C] antitsiklon (atmosfera bosimi yuqori bo`lgan joy)
antidote (to) : n [C] zaharga qarshi dori; chora, iloj, davo
antifreeze : n [U] antifriz (suvning muzlash darajasini pasaytiradigan moddalar)
antipathy (to) : n [U, C] (pl-ies) yoqtirmaslik, xush ko`rmaslik, yomon ko`rish
antique : adj antik, qadimiy, eski
antiseptic : n [U, C] antiseptik (yarani kimyoviy vositalar bilan zararsizlantirish, gazak va yiringlashdan saqlash)
antlers : n [C] bug`u shoxi
antonym : n [C] antonim, qarama-qarshi ma`noli so`z
anus : n anat. [C] (pl-es) anus, anal teshigi (orqa teshik)
anvil : n [C] 1) sandon; 2) ichki tog`ay (quloqda)
anxiety : n (pl-ies) [U,C] xavotir, tashvish, qo`rquv, vahima
anxious : xavotirli, tashvishli, notinch
any : det 1) har kim, har nima; 2) hech kim, hech nima; 3) kimdir, nimadir
anybody : pron biror kishi; har bir
anyhow : adv qanday bo`lmasin; har ehtimolga qarshi
anyone : kimdir, birov; har qanday kishi, hech kimsa
anything : pron nimadir, biror bir narsa, qandaydir, bir narsa
anyway : adv hech bo`lmasa; baribir ham
anywhere : adv biror yerda, hamma joyda, qayerda bo`lmasin
aorta : n [C] pl~s aorta, shohtomir (yurak chap qorinchasidan boshlanadigan, butun tana a`zolarini qon bilan ta`minlaydigan eng katta tomir)
apart : adv alohida, ajralgan holda, ayrim, bo`lak
apartment : n [C] 1) xonadon, kvartira; 2) ~ block; ~ house ko`p qavatli uy; bino
apathy : n [U] befarqlik, beparvolik, e`tiborsizlik
ape : n [C] dumsiz yirik bahaybat maymun
aperture : n [C] teshik, yoriq
apex : n [C] (pl~es) cho`qqi, uch, tepa
apiece : adv donalab
apologize (to, for) [ : vi uzr so`ramoq; kechirim so`ramoq
apoplexy : n [U] falaj, shol
apostle : n [C] 1 xavoriy (Isoning afsonaviy o`n ikki shogirdlaridan biri); 2 qizg`in targ`ibotchi
apostrophe : n [C] xitob, murojaat; undalma; apostrof (belgi)
appal : vt cho`chitmoq, qo`rqitmoq, dahshatga solmoq
apparatus : n [C] (pl~es) komplekt; jihozlar
apparel : n [U] kiyim; kiyim-kechak, libos
apparent (to) : oson tushuniladigan; aniq
apparition : n [C] 1) sharpa, arvoh; 2) xayolot, xayolda ko`ringan narsa
appeal 1 : (to, for) vi chaqirmoq, da`vat qilmoq
appeal 2 : n [C] murojaat, xitob
appear : vi ko`rinmoq, tuyulmoq; o`rtaga chiqmoq; paydo bo`lmoq
appearance : n [U] tashqi, ustki ko`rinish, qiyofa
appease : vt tinchlantirmoq, kelishtirmoq, yarashtirmoq
append (to) : vt ulamoq; qo`shmoq; ilova qilmoq
appendage : n [C] qo`shimcha, ustama
appendicitis : n [U] appenditsit, ko`richak kasali
appendix : n [C] (pl-es) 1) ko`richak; 2) (pl~dices) ilova, qo`shimcha
appetite : n [U, C] ishtaha
appetizer : n [C] ishtaha ochuvchi biror yegulik, gazak
applaud : vi, vt 1) olqishlamoq, chapak chalmoq; 2) ma`qullamoq
applause : n [U] olqish(lar), olqishlash
apple : n [C] olma
appliance : n [C] jihoz; vosita
applicable (to) : mos, uyg`un munosib
applicant : n [C] murojaat qilgan kishi, ariza beruvchi, nomzod
application : n [U, C] 1) murojaat, rasmiy ariza; talab; 2) tajribada qo`llash, tatbiq etish
apply (to, for) : vt, vi (pt, pp-ied) 1) murojaat qilmoq; arz qilmoq, shikoyat qilmoq :  2) qo`llamoq, tajribada sinamoq
appoint (as, to) : vt 1) tayinlamoq, belgilamoq; 2) aniqlamoq, joy-joyiga qo`ymoq
appointment (with) : n [U, C] 1) tayinlash, belgilash (ishga, lavozimga); 2) uchrashuv, ko`rishish
apportion : vt bo`lishmoq, bo`lib olishmoq; taqsimlamoq
appraise : vt baholamoq, baho bermoq
appreciate : vt, vi 1) yuqori baholamoq, qadrlamoq; 2) tushunmoq, e`tiborga olmoq; 3) his etmoq
appreciation : n [C,U] 1) qadrlash, baholash; 2) tushunish, anglash; 3) shukrona, minnatdorchilik
apprehend : vt 1) payqamoq; 2) ushlab qolmoq, qo`lga olmoq
apprehension : n [C,U] 1) tashvish, qo`rquv; 2) tushunish, fahmlash; 3) ushlab olish, tutib olish, qamoqqa olish
apprentice : n [C] shogird
approach 1 : vt, vi yaqinlashmoq
approach 2 : n [U, C] 1) yaqinlashish yaqin kelish; 2) odat, usul, yondashuv
appropriate 1 : (for) vt 1) o`zlashtirmoq, egallab olmoq; 2) mo`ljallamoq; 3) ajratmoq (pul, mablag` haqida)
appropriate 2 : mos, uyg`un, munosib
approval : n [U] 1) mos kelish; ma`qullash; 2) tasdiqlash
approve (of) : vt, vi tasdiqlamoq, ma`qullamoq; qabul qilmoq
approximate 1 : vt, vi yaqinlashmoq, taxminan mos kelmoq, o`xshamoq
approximate 2 : taxminiy, o`xshaydigan, taqribiy
approximately : adv taxminan, taqriban, chamasi
apricot : n [C] o`rik
April : n [C] aprel
apron : n [C] etak, fartuk
apt : adj (er, est) 1) ehtimol, bo`lishi mumkin; 2) mos, munosib, o`rinli; 3) zehnli, ziyrak, qobiliyatli
aptitude : n [C,U] qobiliyat, iqtidor, iste`dod
aqualung : n [C] akvalang (suv ostida bemalol nafas olib suzishga imkon beradigan apparat)
aquarium : n [C] (pl-s or -ria) akvarium
aqueduct : n [C] suv yo`li
Arabic : n [U] arab; arabcha
arable : adj haydaladigan, ekiladigan
arbitrary : adj 1) ixtiyoriy, erkin; 2) asossiz, mantiqsiz (o`zboshimchalik bilan qilingan qaror)
arbitrate : vt, vi 1) hakamlik qilmoq; 2) kelishtirmoq
arbitrator : n [C] hakam, vositachi
arc : n [C] arka; kamar; kamon, yoy
arcade : n [C] usti yopiq bozor
arch : n [C] ark, peshtoq, qubba
archaeology : n [U] arxeologiya
archaic : adj qadimgi, eskirgan, arxaik
archangel : n [C] arxangel(farishtalarning, malikalarning eng kattasi), asosiy farishta
archbishop : n [C] bosh yepiskop
archer : n [C] kamonboz
archipelago : n [C] (pl~s) bir guruh orollar (bir-biriga yaqin orollari)
architect : n [C] me`mor
architecture : n [U] arxitektura, me`moriy usul, me`morchilik
archives : n, pl arxiv
Arctic : n [C] Arktika, Shimoliy Qutb
ardent : jo`shqin, g`ayratli, ehtirosli
ardour : n [C,U] zavq-shavq, ishtiyoq
arduous : adj qiyin, og`ir, mushkul
are 1 : v to be fe/lining hozirgi zamon, ko`plik shakli
are 2 : n [C] ar (o`lchov birligi = 100m 2), yer o`lchovi
area : n [C] doira; soha; maydon; faoliyat sohasi
arena : n [C] (pl~s) maydon; arena
argue : (with, over, about) vi, vt 1) tortishmoq, bahslashmoq, munozara qilmoq; 2) isbot qilmoq, ishontirmoq
argument : n [C,U] 1) bahs, munozara, tortishuv; 2) dalil, isbot
arid : qurg`oq, quruq (suvsiz)
arise (from) : vi (pt arose, pp arisen) sodir bo`lmoq; o`rtaga chiqmoq; paydo bo`lmoq; ko`tarilmoq
arisen : qarang arise
aristocracy [ : n (pl~ies) [U, C] zodagonlar tabaqasi
aristocrat : n [C] zodagon, aristokrat
arithmetic 1 : n [U] arifmetika
arithmetical : arifmetikaga oid
ark : n kema; Nuh payg`ambar kemasi
arm 1 : n [C] 1) qo`l; 2) the ~ harbiy bo`lim; qurol
arm 2 : vt, vi qurollantirmoq, qurollanmoq
armada : n [C] (pl~s) armada (harbiy kema yoki samolyotlarning birikmasi)
armament : n [C] pl 1) qurol â yarog`, aslaha; 2) qurollanish
arm-chair : n [C] kreslo
armed : qurollangan, qurolli
armistice : n [C] yarash, vaqtinchalik sulh (urushuvchi tomonlarning kelishuvi bilan vaqtinchalik urush harakatlarini to`xtatish)
armor : n [U] zirh, skafandr
armpit : n qo`ltiq
arms : n, pl qurollar. o`q-dori
army : n [C] (pl-ies) armiya, qo`shin
aroma : n [C] xushboy hid, shirin is, muattar hid
arose : qarang arise
around : adv, prep 1) har tarafda, to`rt tomonda; 2) atrofda, tevaragida, aylana; 3) atrofida; 4) yaqin, taxminan
arouse : vt 1) uyg`otmoq, turg`izmoq; 2) jonlantirmoq, harakatga keltirmoq, qo`zg`atmoq
arrange : vt, vi 1) joy-joyiga qo`ymoq, tartibga solmoq; solmoq; 2) kelishilmoq, kelishib olmoq; 3) tashkil etmoq, uyushtirmoq, tuzmoq
arrangement : n [U, C] 1) tartibga keltirish, joylashish, joylashtirish; 2) aranjirovka; moslashtirish; 3) tadbir, chora
array : n [C] tartib; ko`rsatuv, ko`rik; namoyish
arrears : n, pl qarz; kechiktirilgan qarz, soliq
arrest : vt qamamoq, qamoqqa olmoq, hibsga olmoq
arrival : n [U, C] yetib kelish
arrive : vi yetib kelmoq, kelmoq; erishmoq
arrogance : n [C] takabburlik, kibr, kekkayishlik, mag`rurlik
arrogant : mag`rur; kibrli; dimog`dor
arrow : n [C] nayza; kamon o`qi
arsenal : n [C] qurol - yarog` bazasi
arsenic : n [U] arsinik (kuchli zahar), margimush
arson : n [U] ataylab o`t qo`yish, yoqib yuborish
art : n [U, C] 1) san`at; 2) hunar; ustalik, mohirlik; mahorat
artery : n [C] (pl-ies) 1) arteriya qon tomiri; 2) katta yo`l, katta daryo
artful : adj 1) ayyor, quv, mug`ombir; 2) mohirlik va ustalik bilan ishlagan
arthritis : n [U] bo`g`in yallig`lanishi, artrit
artichoke : n [C] artishok (o`tsimon poliz o`simligi)
article : n [C] 1) narsa, buyum; 2) maqola; 3) modda, bob (qonun to`g`risida); 4) (gram) artikl
articulate 1 : vt, vi ravshan gapirmoq, aniq talaffuz qilmoq
articulate 2 : aniq aytilgan, aniq talaffuz qilingan
artificial : sun`iy; qalbaki, soxta
artillery : n [U] artileriya (to`p, zambarak kabi qurollar)
artisan : n [C] hunarmand, kosib.
artist : n [C] 1) sana`tkor; rassom; 2) o`z ishining ustasi
artistic : adj sana`tkorona, mohirona; badiiy
artless : adj sodda, go`l, anoyi; ma`sum; tabiiy
as 1 : pron rel 1) qaysiki, ya`ni ma`nosida :  This is the same book as I lost Bu o`sha men yoqotgan kitob
as 2 : adv 1) o`shanday, ana shunday, xuddi shunaqa :  Do as you are told Sizga nima deyilgan bo`lsa, shunday qiling; 2) singari, kabi :  some animals, as the fox and wold bo`ri va tulki singari ba`zi jonivorlar; 3) sifatida, vazifasida, o`rnida :  to oppear as Hamle
as 3 : cj 1) qachon, qachonki, paytda, vaqtda, zamonda :  He came in as I was speaking Men gapirayotganimda u kirib keldi; 2) chunki, negaki; I could not stay, as it was late Kech bo`lganligi sababli qola olmadim; 3) qaramay, garchi; -sa ham; cunning as he is he
ascend : vt, vi 1) yuksalmoq, chiqmoq, ko`tarilmoq; 2) taxtga o`tirmoq, mavqega erishmoq
ascent : n [C] 1) yuksalish, chiqish, ko`tarilish; 2) tiklik, tik qiyalik
ascertain : vi ishonmoq, inonmoq
ascetic : adj tarki dunyo qilgan, zohid
ascribe : vt mansub deb bilmoq, ...deb tushunmoq, ...deb o`ylamoq
aseptic : mikrobdan xoli, toza, aseptik
ash : n [U] kul
ashamed (be~of) : uyatchan, tortinchoq; uyalgan, uyaladigan
ashore : adv qirg`oqda, sohilda; quruqlikda
ash-tray : n [C] kuldon
ashy : kulrang, rangpar
aside : adv chekkaga, chetga; bir tarafda
ask (about) : vt, vi 1) so`ramoq, savol bermoq; 2) iltimos qilmoq, xohlamoq
asleep : adj uyquda, uxlayotgan
asparagus : n [U] sarsabil (ko`p yillik sabzavot o`simligi)
aspect : n [C] 1) tomon, aspekt; 2) tomon, tasvir, ko`rinish
asphalt : n [U] asfalt
aspiration : n [C,U] orzu, istak, xohish; ishtiyoq
aspire : vi xohlamoq, orzu qilmoq, intilmoq
aspirin : n aspirin (dorining nomi)
ass : n [C] 1) eshak, xachir; 2) tentak, ahmoq odam
assail : vt hujum qilmoq, shiddat bilan hujum qilmoq
assassin : n [C] siyosiy yoki jamoat arbobining qotili
assassinate : vt qotillik sodir qilmoq
assault : n [C] qo`qqisdan hujum qilish, bostirib kirish
assay : n tahlil, sinov, tekshiruv
assemble : vt, vi yig`moq, yig`ilmoq
assembly : n [C] (pl-ies) 1) assambleya; kengash (biror xalqaro jamiyatning yalpi majlisi); 2) [U] montaj; yig`ish, to`plash
assent : vi 1) tasdiqlamoq, qarorlashtirmoq; 2) himoya qilmoq, saqlab qolmoq
assert : vt bayon qilmoq; o`z fikrida qat`iy turmoq; o`z huquqini talashmoq
assertion : n [U, C] tasdiqlash, tasdiqlanish
assertive : adj tasdiqlaydigan
assess : vt aniqlamoq; baholamoq; belgilamoq
assessment : n [C,U] baholash, baho berish
asset : n [C] pl 1) mol-mulk; 2) foyda, yordam
assiduous : ehtiyotkor, sinchkov; g`ayratli, harakatchan
assign (to) : vt 1) tayinlamoq, ajratmoq; 2) belgilamoq (muddatni, chegarani)
assignment : n [C,U] 1) ish, vazifa; 2) lavozimga tayinlash, belgilash
assimilate : vt, vi 1) o`xshatmoq; ta`sirida o`zgartirmoq; 2) parchalamoq; hazm qilmoq, singdirmoq
assimilation : n [U] assimilyatsiya (aralashib bir bo`lib yoki o`xshab ketish)
assist (in, with) : vt, vi yordam bermoq, ko`maklashmoq
assistance : n [U] yordam, ko`mak
assistant : n [C] yordamchi, muovin, o`rinbosar
associate 1 (with) v : vt, vi 1) qo`shmoq, birlashtirmoq; 2) bog`lamoq, birga qo`shmoq
associate 2 : n [C] hamkor; kasbdosh
association : n [U,C] uyushma ittifoq; birlashma, tashkilot
assorted : adj aralash, anvoyi to`plam
assume : vt 1) faraz qilmoq, taxmin qilmoq; 2) bo`yniga olmoq, zimmasiga olmoq
assumption : n [C] 1) gipoteza, taxmin, faraz; 2) mas`uliyatni o`z zimmasiga olish; tan olish
assurance (of) : n [U, C] 1) ishonch, ishonish; 2) o`z-o`zini katta olish, o`ziga ishonish, manmanlik; 3) sug`urta
assure (of) : vt 1) kafil bo`lmoq, kafolat bermoq; ta`minlamoq; 2) va`da bermoq, so`z bermoq, ishontirmoq
asterisk : n [C] yulduzcha belgisi
asthma : n [U] astma, ko`ksov
astonish : vt hayratlantirmoq, qoyil qoldirmoq
astound : vt hayratda qoldirmoq, qoyil qoldirmoq
astray : adv adashib
astride : adv oyoqlarni osiltirib (otga mingandek)
astrology : n [U] astrologiya, ilminujum (yulduzlarga qarab fol ochish)
astronaut : n [C] astronavt, kosmonavt
astronomical : 1) astronomiyaga oid; 2) juda katta, yuksak, astronomik
astronomy : n [U] astronomiya (osmon jismlari va ularning sistemalari, tuzilishi, harakati haqidagi fan)
astute : ziyrak; ayyor; quv
asylum : n [C,U] 1) boshpana; 2) aqli zaiflar kasalxonasi
at : prep 1) ... da :  ~ a meeting, ~ home majlisda; uyda; 2) yonida, atrofida, oldida :  ~ the door eshik yonida; 3) paytida :  a) ~ 5 o`clock ~ dawn tong sahar 5 da; b) yosh haqida :  ~ the age of 60, ~ an early age 60 (yosh)da; erta yoshda; yoshlik chog`ida; 4) ~
ate : qarang eat
atheism : n [U] ateizm, xudoga ishonmaslik, xudosizlik, kofirlik
athlete : n [C] sportchi
athletic : baquvvat, sog`lom
athletics : n [U] yengil atletika
Atlantic : adj atlantikaga oid
Atlas : n [C] atlas
atmosphere : n [C] atmosfera
atoll : n [C] marjon oroli
atom : n [C] atom
atomic : atomga oid
atone (for) : vi aybini yumshatmoq; gunohini kechirishga yarasha ishlamoq
atrocious : yomon; xunuk; vahshiy, zolim
atrocity : n [U, C] (pl-ies) berahmlik, zolimlik, beshafqatlik; vahshiylik
attach (to) : vt mahkamlamoq; yopishtirmoq; biriktirmoq
attache : n [C] attashe (elchixona huzuriga rasmiy ravishda yuborilgan biror soha vakili)
attachment : n [U, C] 1) biriktirish, mahkamlash; 2) mehr qo`yish, bog`liqlik, yaqinlik
attack 1 : vi, vt 1) hujum qilmoq, bostirib kirmoq; 2) tanqid qilmoq; 3) tashlanmoq
attack 2 : n [C] hujum, bosqin
attain : vt erishmoq, yetishmoq, qozonmoq
attempt 1 : vt urinib ko`rmoq, urinmoq(ishga) kirishmoq, harakat qilmoq
attempt 2 : n [C] harakat, urinish, tirishish
attend : vt, vi 1) ahamiyat bermoq, shug`ullanmoq (masala, ish bilan); 2) g`amxo`rlik qilmoq, qaramoq (bemorga); 3) mashg`ulotga qatnashmoq
attendance : n [C,U] 1) qatnashish, ishtirok etish, davomat; 2) qatnashuvchilar, ishtirokchilar
attendant : n [C] xizmatkor (qorovul, soqchi)
attention : n [U] 1) qarash, qayg`urish; 2) diqqat, e`tibor, ahamiyat
attentive : 1) hushyor, ziyrak; 2) g`amxo`r, mehribon
attest : vt, vi 1) isbotlamoq; dalil keltirmoq tasdiqlamoq; 2) qasamyod qildirmoq
attic : n [C] mansarda, qiya shift bolaxona
attitude : n [C] 1) xatti-harakat, munosabat; 2) xulq, xarakter
attorney : n [C] (pl~s) prokuror; huquqshunos, advokat; vakil
attract : vt 1) jalb etmoq, o`ziga tortmoq; 2) ko`nglini band etmoq, maftun etmoq
attraction : n [U] 1) joziba, o`ziga tortish, maftun etish; 2) fiz. tortish; o`ziga tortish
attractive : 1) jozibador, o`ziga tortadigan dilbar; 2) fiz. ~ power tortish kuchi
attribute 1 : vt 1) yozib qo`ymoq, qayd qilmoq; 2) nisbat bermoq, ... deb tushunmoq
attribute 2 : n [C] 1) xususiyat, o`ziga xoslik, belgi; 2) gram. aniqlovchi
aubergine : n [C] baqlajon
auburn : adj qizg`ish jigarrang (soch haqida)
auction : n [C,U] auksion, kim oshdi savdosi; to put up for (amer. at) kim oshdi savdosida sotmoq
audacious : adj 1) jasur, botir 2) g`ashga tegadigan, behayo, surbet
audible : adj baland, eshitiladigan, aniq, burro
audience : n [C] tinglovchi; tomoshabin
audio : adj eshitishga oid.
audiovisual : adj tasviriy va ovozli
audit : vt tekshirmoq, nazorat qilmoq, taftish etmoq
auditorium : n [C] (pl~s) zal, saroy (tamosha zali, auditoriya)
augment : vt, vi orttirmoq, ko`paytirmoq
August : n [U, C] avgust
aunt : n [C] xola; amma
au pair : n fr. xizmatkor, til o`rganish maqsadida, bir oilaning uy ishlariga ko`maklashib yashaydigan chet ellik qiz
aural : adj eshitishga oid
auspicious : adj ko`ngildagidek, ajoyib
austere : og`ir, qiyin, noqulay
authentic : adj 1) asl; 2) aniq ishonchli
author : n [C] yozuvchi, muallif
authoritarian : adj avtoritar, buyruqboz; to`ralarcha boshqaruv, o`z hukmini o`tkazadigan
authoritative : adj rasmiy; obro`li, e`tiborli
authority : n [U,C] (pl~ies) 1) hokimiyat, huquq, vakolat; 2) vakolatga ega; biror ish qilish huquqiga egalik
authorize : vt 1) vakolat bermoq; zimmasiga yuklamoq; 2) ruxsat bermoq; tasdiqlamoq
auto 1 : n [C] abbr. 1 yengil mashina;
auto 2 : pref o`zi tomonidan
autobiography : n [C] (pl~ies) tarjimai hol, avtobiografiya
autocrat : n [C] diktator, avtokrat, hokimi mutlaq, mustabid hokim
autograph : n [C] 1) muallifning dastxati yoki imzosi; 2) avtograf (muallif imzosi)
automatic : adj 1) avtomatik ravishda ishlaydigan; 2) g`ayriixtiyoriy ravishda sodir boladigan mashina
automation : n [U] avtomatlashtirish (harakat haqida)
automobile : n [C] avtomobil
autonomous : adj muxtor, avtonom
autonomy : n [C,U] (pl~ies) muxtoriyat (o`z-o`zini mustaqil boshqarish, idora qilish huquqi)
autopsy : n [C] (pl-ies) o`likni yorib ko`rish
autumn : n [C] kuz
auxiliary : adj 1) ko`makchi, yordamchi; 2) gram. ~ verb ko`makchi fe`l
available (to) : 1) yaroqli, foydali; 2) loyiq, yaraydigan, kerakli
avalanche : n [C] qor ko`chkisi
avenge : vt o`ch olmoq, qasos olmoq; to ~ onesalf qasos olmoq
avenue : n [C] shohko`cha, prospekt (AQSHda)
average 1 : n [C] o`rtacha hisobda; o`rtacha miqdorda
average 2 : adj o`rta, o`rtacha, o`rtacha songa oid
averse : adj sevmaydigan; yoqimsiz
aversion : n [C] yoqtirmaslik, xush ko`rmaslik
avert : vt 1) chalg`itmoq, adashtirmoq; 2) oldini olmoq, daf qilmoq
aviation : n [U] aviatsiya (havodan og`ir apparatlarda uchish nazariyasi va amaliyoti)
avid : ochko`z, hirs qo`ygan, hirsli
avocado : n [C] bot. (pl~s) avokado (nok daraxtiga o`xshash yashil bargli, po`stlog`i qalin daraxt)
avoid : vt 1) o`zini chetga olmoq, bosh tortmoq; 2) ehtiyot bo`lmoq, saqlanmoq
avow : vt e`tirof etmoq; ochiqchasiga so`zlamoq
await : vt kutmoq
awake 1 : vi, vt (pt, awoken) 1) hushyor tortmoq, sergak bo`lmoq 2) uyg`otmoq
award : n [C] (mukofot va shu kabilar) berish, berilish; belgilash, qaror qilish
aware : xabardor; biluvchi, bilimdon
away 1 : adv uzoqda, uzoqqa; o`zga yerda; chetga, chetda
away 2 : adj qarshi tomonda
awe : n [U] 1) qo`rquv, titroq, larza; 2) izzat-hurmat, ehtirom
awful : adj qo`rqinchli; vahimali, mudhish; yomon
awhile : adv qisqa vaqtli
awkward : adj 1) noshud; uquvsiz, o`xshovsiz; 2) noqulay, o`ng`ay emas, beso`naqay
awning : n [C,U] chodir, bostirma
awoke : qarang awake
awoken : qarang awake
awry : 1) egri, qiyshiq; 2) xato, noto`g`ri
axe : n [C] (pl~s) bolta
axiom : n [C] aksioma (isbot talab qilmaydigan haqiqat)
axis : n [C] o`q (mashina, yer o`qi)
axle : n [C] tex. o`q, o`zak
aye : int xo`p, ha
azure : moviy, zangori